10 10
##########
#        #
#        #
#        #
####-#####
#        #
#        #
#        #
#        #
##########
1
8 5
8 6